alias k='kubectl'
alias ka='kubectl apply -f'
alias kex='kubectl exec -i -t'
alias klo='kubectl logs -f'
alias kp='kubectl proxy'
alias kg='kubectl get'
alias kd='kubectl describe'
alias krm='kubectl delete'
alias kgns='kubectl get namespaces'
alias kdns='kubectl describe namespaces'
alias krmns='kubectl delete namespaces'
alias kgoyaml='kubectl get -o=yaml'
alias kgnsoyaml='kubectl get namespaces -o=yaml'
alias kgowide='kubectl get -o=wide'
alias kgnsowide='kubectl get namespaces -o=wide'
alias kgojson='kubectl get -o=json'
alias kgnsojson='kubectl get namespaces -o=json'
alias kgall='kubectl get --all-namespaces'
alias kdall='kubectl describe --all-namespaces'
alias kgnsall='kubectl get namespaces --all-namespaces'
alias kdnsall='kubectl describe namespaces --all-namespaces'
alias krmall='kubectl delete --all'
alias krmnsall='kubectl delete namespaces --all'
alias kgw='kubectl get --watch'
alias kgnsw='kubectl get namespaces --watch'
alias kgoyamlall='kubectl get -o=yaml --all-namespaces'
alias kgnsoyamlall='kubectl get namespaces -o=yaml --all-namespaces'
alias kgalloyaml='kubectl get --all-namespaces -o=yaml'
alias kgnsalloyaml='kubectl get namespaces --all-namespaces -o=yaml'
alias kgwoyaml='kubectl get --watch -o=yaml'
alias kgnswoyaml='kubectl get namespaces --watch -o=yaml'
alias kgowideall='kubectl get -o=wide --all-namespaces'
alias kgnsowideall='kubectl get namespaces -o=wide --all-namespaces'
alias kgallowide='kubectl get --all-namespaces -o=wide'
alias kgnsallowide='kubectl get namespaces --all-namespaces -o=wide'
alias kgwowide='kubectl get --watch -o=wide'
alias kgnswowide='kubectl get namespaces --watch -o=wide'
alias kgojsonall='kubectl get -o=json --all-namespaces'
alias kgnsojsonall='kubectl get namespaces -o=json --all-namespaces'
alias kgallojson='kubectl get --all-namespaces -o=json'
alias kgnsallojson='kubectl get namespaces --all-namespaces -o=json'
alias kgwojson='kubectl get --watch -o=json'
alias kgnswojson='kubectl get namespaces --watch -o=json'
alias kgallw='kubectl get --all-namespaces --watch'
alias kgnsallw='kubectl get namespaces --all-namespaces --watch'
alias kgwall='kubectl get --watch --all-namespaces'
alias kgnswall='kubectl get namespaces --watch --all-namespaces'
alias kgallwoyaml='kubectl get --all-namespaces --watch -o=yaml'
alias kgnsallwoyaml='kubectl get namespaces --all-namespaces --watch -o=yaml'
alias kgwoyamlall='kubectl get --watch -o=yaml --all-namespaces'
alias kgnswoyamlall='kubectl get namespaces --watch -o=yaml --all-namespaces'
alias kgwalloyaml='kubectl get --watch --all-namespaces -o=yaml'
alias kgnswalloyaml='kubectl get namespaces --watch --all-namespaces -o=yaml'
alias kgallwowide='kubectl get --all-namespaces --watch -o=wide'
alias kgnsallwowide='kubectl get namespaces --all-namespaces --watch -o=wide'
alias kgwowideall='kubectl get --watch -o=wide --all-namespaces'
alias kgnswowideall='kubectl get namespaces --watch -o=wide --all-namespaces'
alias kgwallowide='kubectl get --watch --all-namespaces -o=wide'
alias kgnswallowide='kubectl get namespaces --watch --all-namespaces -o=wide'
alias kgallwojson='kubectl get --all-namespaces --watch -o=json'
alias kgnsallwojson='kubectl get namespaces --all-namespaces --watch -o=json'
alias kgwojsonall='kubectl get --watch -o=json --all-namespaces'
alias kgnswojsonall='kubectl get namespaces --watch -o=json --all-namespaces'
alias kgwallojson='kubectl get --watch --all-namespaces -o=json'
alias kgnswallojson='kubectl get namespaces --watch --all-namespaces -o=json'
alias kgf='kubectl get -f'
alias kdf='kubectl describe -f'
alias krmf='kubectl delete -f'
alias kgoyamlf='kubectl get -o=yaml -f'
alias kgowidef='kubectl get -o=wide -f'
alias kgojsonf='kubectl get -o=json -f'
alias kgwf='kubectl get --watch -f'
alias kgwoyamlf='kubectl get --watch -o=yaml -f'
alias kgwowidef='kubectl get --watch -o=wide -f'
alias kgwojsonf='kubectl get --watch -o=json -f'
alias kgl='kubectl get -l'
alias kdl='kubectl describe -l'
alias krml='kubectl delete -l'
alias kgnsl='kubectl get namespaces -l'
alias kdnsl='kubectl describe namespaces -l'
alias krmnsl='kubectl delete namespaces -l'
alias kgoyamll='kubectl get -o=yaml -l'
alias kgnsoyamll='kubectl get namespaces -o=yaml -l'
alias kgowidel='kubectl get -o=wide -l'
alias kgnsowidel='kubectl get namespaces -o=wide -l'
alias kgojsonl='kubectl get -o=json -l'
alias kgnsojsonl='kubectl get namespaces -o=json -l'
alias kgwl='kubectl get --watch -l'
alias kgnswl='kubectl get namespaces --watch -l'
alias kgwoyamll='kubectl get --watch -o=yaml -l'
alias kgnswoyamll='kubectl get namespaces --watch -o=yaml -l'
alias kgwowidel='kubectl get --watch -o=wide -l'
alias kgnswowidel='kubectl get namespaces --watch -o=wide -l'
alias kgwojsonl='kubectl get --watch -o=json -l'
alias kgnswojsonl='kubectl get namespaces --watch -o=json -l'
alias kexn='kubectl exec -i -t --namespace'
alias klon='kubectl logs -f --namespace'
alias kgn='kubectl get --namespace'
alias kdn='kubectl describe --namespace'
alias krmn='kubectl delete --namespace'
alias kgoyamln='kubectl get -o=yaml --namespace'
alias kgowiden='kubectl get -o=wide --namespace'
alias kgojsonn='kubectl get -o=json --namespace'
alias kgwn='kubectl get --watch --namespace'
alias kgwoyamln='kubectl get --watch -o=yaml --namespace'
alias kgwowiden='kubectl get --watch -o=wide --namespace'
alias kgwojsonn='kubectl get --watch -o=json --namespace'

# Pods
alias kgpo='kubectl get pods'
alias kdpo='kubectl describe pods'
alias krmpo='kubectl delete pods'
alias kgpooyaml='kubectl get pods -o=yaml'
alias kgpoowide='kubectl get pods -o=wide'
alias kgpoojson='kubectl get pods -o=json'
alias kgpoall='kubectl get pods --all-namespaces'
alias kdpoall='kubectl describe pods --all-namespaces'
alias krmpoall='kubectl delete pods --all'
alias kgpow='kubectl get pods --watch'
alias kgpooyamlall='kubectl get pods -o=yaml --all-namespaces'
alias kgpoalloyaml='kubectl get pods --all-namespaces -o=yaml'
alias kgpowoyaml='kubectl get pods --watch -o=yaml'
alias kgpoowideall='kubectl get pods -o=wide --all-namespaces'
alias kgpoallowide='kubectl get pods --all-namespaces -o=wide'
alias kgpowowide='kubectl get pods --watch -o=wide'
alias kgpoojsonall='kubectl get pods -o=json --all-namespaces'
alias kgpoallojson='kubectl get pods --all-namespaces -o=json'
alias kgpowojson='kubectl get pods --watch -o=json'
alias kgpoallw='kubectl get pods --all-namespaces --watch'
alias kgpowall='kubectl get pods --watch --all-namespaces'
alias kgpoallwoyaml='kubectl get pods --all-namespaces --watch -o=yaml'
alias kgpowoyamlall='kubectl get pods --watch -o=yaml --all-namespaces'
alias kgpowalloyaml='kubectl get pods --watch --all-namespaces -o=yaml'
alias kgpoallwowide='kubectl get pods --all-namespaces --watch -o=wide'
alias kgpowowideall='kubectl get pods --watch -o=wide --all-namespaces'
alias kgpowallowide='kubectl get pods --watch --all-namespaces -o=wide'
alias kgpoallwojson='kubectl get pods --all-namespaces --watch -o=json'
alias kgpowojsonall='kubectl get pods --watch -o=json --all-namespaces'
alias kgpowallojson='kubectl get pods --watch --all-namespaces -o=json'
alias kgpol='kubectl get pods -l'
alias kdpol='kubectl describe pods -l'
alias krmpol='kubectl delete pods -l'
alias kgpooyamll='kubectl get pods -o=yaml -l'
alias kgpoowidel='kubectl get pods -o=wide -l'
alias kgpoojsonl='kubectl get pods -o=json -l'
alias kgpowl='kubectl get pods --watch -l'
alias kgpowoyamll='kubectl get pods --watch -o=yaml -l'
alias kgpowowidel='kubectl get pods --watch -o=wide -l'
alias kgpowojsonl='kubectl get pods --watch -o=json -l'
alias kgpon='kubectl get pods --namespace'
alias kdpon='kubectl describe pods --namespace'
alias krmpon='kubectl delete pods --namespace'
alias kgpooyamln='kubectl get pods -o=yaml --namespace'
alias kgpoowiden='kubectl get pods -o=wide --namespace'
alias kgpoojsonn='kubectl get pods -o=json --namespace'
alias kgpown='kubectl get pods --watch --namespace'
alias kgpowoyamln='kubectl get pods --watch -o=yaml --namespace'
alias kgpowowiden='kubectl get pods --watch -o=wide --namespace'
alias kgpowojsonn='kubectl get pods --watch -o=json --namespace'

# Deployments
alias kgdep='kubectl get deployment'
alias kddep='kubectl describe deployment'
alias krmdep='kubectl delete deployment'
alias kedep='kubectl edit deployment'
alias kgdepoyaml='kubectl get deployment -o=yaml'
alias kgdepowide='kubectl get deployment -o=wide'
alias kgdepojson='kubectl get deployment -o=json'
alias kgdepall='kubectl get deployment --all-namespaces'
alias kddepall='kubectl describe deployment --all-namespaces'
alias krmdepall='kubectl delete deployment --all'
alias kgdepw='kubectl get deployment --watch'
alias kgdepoyamlall='kubectl get deployment -o=yaml --all-namespaces'
alias kgdepalloyaml='kubectl get deployment --all-namespaces -o=yaml'
alias kgdepwoyaml='kubectl get deployment --watch -o=yaml'
alias kgdepowideall='kubectl get deployment -o=wide --all-namespaces'
alias kgdepallowide='kubectl get deployment --all-namespaces -o=wide'
alias kgdepwowide='kubectl get deployment --watch -o=wide'
alias kgdepojsonall='kubectl get deployment -o=json --all-namespaces'
alias kgdepallojson='kubectl get deployment --all-namespaces -o=json'
alias kgdepwojson='kubectl get deployment --watch -o=json'
alias kgdepallw='kubectl get deployment --all-namespaces --watch'
alias kgdepwall='kubectl get deployment --watch --all-namespaces'
alias kgdepallwoyaml='kubectl get deployment --all-namespaces --watch -o=yaml'
alias kgdepwoyamlall='kubectl get deployment --watch -o=yaml --all-namespaces'
alias kgdepwalloyaml='kubectl get deployment --watch --all-namespaces -o=yaml'
alias kgdepallwowide='kubectl get deployment --all-namespaces --watch -o=wide'
alias kgdepwowideall='kubectl get deployment --watch -o=wide --all-namespaces'
alias kgdepwallowide='kubectl get deployment --watch --all-namespaces -o=wide'
alias kgdepallwojson='kubectl get deployment --all-namespaces --watch -o=json'
alias kgdepwojsonall='kubectl get deployment --watch -o=json --all-namespaces'
alias kgdepwallojson='kubectl get deployment --watch --all-namespaces -o=json'
alias kgdepl='kubectl get deployment -l'
alias kddepl='kubectl describe deployment -l'
alias krmdepl='kubectl delete deployment -l'
alias kgdepoyamll='kubectl get deployment -o=yaml -l'
alias kgdepowidel='kubectl get deployment -o=wide -l'
alias kgdepojsonl='kubectl get deployment -o=json -l'
alias kgdepwl='kubectl get deployment --watch -l'
alias kgdepwoyamll='kubectl get deployment --watch -o=yaml -l'
alias kgdepwowidel='kubectl get deployment --watch -o=wide -l'
alias kgdepwojsonl='kubectl get deployment --watch -o=json -l'
alias kgdepn='kubectl get deployment --namespace'
alias kddepn='kubectl describe deployment --namespace'
alias krmdepn='kubectl delete deployment --namespace'
alias kgdepoyamln='kubectl get deployment -o=yaml --namespace'
alias kgdepowiden='kubectl get deployment -o=wide --namespace'
alias kgdepojsonn='kubectl get deployment -o=json --namespace'
alias kgdepwn='kubectl get deployment --watch --namespace'
alias kgdepwoyamln='kubectl get deployment --watch -o=yaml --namespace'
alias kgdepwowiden='kubectl get deployment --watch -o=wide --namespace'
alias kgdepwojsonn='kubectl get deployment --watch -o=json --namespace'

# Service
alias kgsvc='kubectl get service'
alias kdsvc='kubectl describe service'
alias krmsvc='kubectl delete service'
alias kgsvcoyaml='kubectl get service -o=yaml'
alias kgsvcowide='kubectl get service -o=wide'
alias kgsvcojson='kubectl get service -o=json'
alias kgsvcall='kubectl get service --all-namespaces'
alias kdsvcall='kubectl describe service --all-namespaces'
alias krmsvcall='kubectl delete service --all'
alias kgsvcw='kubectl get service --watch'
alias kgsvcoyamlall='kubectl get service -o=yaml --all-namespaces'
alias kgsvcalloyaml='kubectl get service --all-namespaces -o=yaml'
alias kgsvcwoyaml='kubectl get service --watch -o=yaml'
alias kgsvcowideall='kubectl get service -o=wide --all-namespaces'
alias kgsvcallowide='kubectl get service --all-namespaces -o=wide'
alias kgsvcwowide='kubectl get service --watch -o=wide'
alias kgsvcojsonall='kubectl get service -o=json --all-namespaces'
alias kgsvcallojson='kubectl get service --all-namespaces -o=json'
alias kgsvcwojson='kubectl get service --watch -o=json'
alias kgsvcallw='kubectl get service --all-namespaces --watch'
alias kgsvcwall='kubectl get service --watch --all-namespaces'
alias kgsvcallwoyaml='kubectl get service --all-namespaces --watch -o=yaml'
alias kgsvcwoyamlall='kubectl get service --watch -o=yaml --all-namespaces'
alias kgsvcwalloyaml='kubectl get service --watch --all-namespaces -o=yaml'
alias kgsvcallwowide='kubectl get service --all-namespaces --watch -o=wide'
alias kgsvcwowideall='kubectl get service --watch -o=wide --all-namespaces'
alias kgsvcwallowide='kubectl get service --watch --all-namespaces -o=wide'
alias kgsvcallwojson='kubectl get service --all-namespaces --watch -o=json'
alias kgsvcwojsonall='kubectl get service --watch -o=json --all-namespaces'
alias kgsvcwallojson='kubectl get service --watch --all-namespaces -o=json'
alias kgsvcl='kubectl get service -l'
alias kdsvcl='kubectl describe service -l'
alias krmsvcl='kubectl delete service -l'
alias kgsvcoyamll='kubectl get service -o=yaml -l'
alias kgsvcowidel='kubectl get service -o=wide -l'
alias kgsvcojsonl='kubectl get service -o=json -l'
alias kgsvcwl='kubectl get service --watch -l'
alias kgsvcwoyamll='kubectl get service --watch -o=yaml -l'
alias kgsvcwowidel='kubectl get service --watch -o=wide -l'
alias kgsvcwojsonl='kubectl get service --watch -o=json -l'
alias kgsvcn='kubectl get service --namespace'
alias kdsvcn='kubectl describe service --namespace'
alias krmsvcn='kubectl delete service --namespace'
alias kgsvcoyamln='kubectl get service -o=yaml --namespace'
alias kgsvcowiden='kubectl get service -o=wide --namespace'
alias kgsvcojsonn='kubectl get service -o=json --namespace'
alias kgsvcwn='kubectl get service --watch --namespace'
alias kgsvcwoyamln='kubectl get service --watch -o=yaml --namespace'
alias kgsvcwowiden='kubectl get service --watch -o=wide --namespace'
alias kgsvcwojsonn='kubectl get service --watch -o=json --namespace'

# Roles
alias kgro='kubectl get roles'
alias kero='kubectl edit role'
alias kdro='kubectl describe roles'
alias krmro='kubectl delete roles'

# Role Binding
alias kgrb='kubectl get rolebindings'
alias kerb='kubectl edit rolebinding'
alias kdrb='kubectl describe rolebinding'
alias krmrb='kubectl delete rolebinding'

# Ingress
alias kging='kubectl get ingress'
alias kding='kubectl describe ingress'
alias krming='kubectl delete ingress'
alias kgingoyaml='kubectl get ingress -o=yaml'
alias kgingowide='kubectl get ingress -o=wide'
alias kgingojson='kubectl get ingress -o=json'
alias kgingall='kubectl get ingress --all-namespaces'
alias kdingall='kubectl describe ingress --all-namespaces'
alias krmingall='kubectl delete ingress --all'
alias kgingw='kubectl get ingress --watch'
alias kgingoyamlall='kubectl get ingress -o=yaml --all-namespaces'
alias kgingalloyaml='kubectl get ingress --all-namespaces -o=yaml'
alias kgingwoyaml='kubectl get ingress --watch -o=yaml'
alias kgingowideall='kubectl get ingress -o=wide --all-namespaces'
alias kgingallowide='kubectl get ingress --all-namespaces -o=wide'
alias kgingwowide='kubectl get ingress --watch -o=wide'
alias kgingojsonall='kubectl get ingress -o=json --all-namespaces'
alias kgingallojson='kubectl get ingress --all-namespaces -o=json'
alias kgingwojson='kubectl get ingress --watch -o=json'
alias kgingallw='kubectl get ingress --all-namespaces --watch'
alias kgingwall='kubectl get ingress --watch --all-namespaces'
alias kgingallwoyaml='kubectl get ingress --all-namespaces --watch -o=yaml'
alias kgingwoyamlall='kubectl get ingress --watch -o=yaml --all-namespaces'
alias kgingwalloyaml='kubectl get ingress --watch --all-namespaces -o=yaml'
alias kgingallwowide='kubectl get ingress --all-namespaces --watch -o=wide'
alias kgingwowideall='kubectl get ingress --watch -o=wide --all-namespaces'
alias kgingwallowide='kubectl get ingress --watch --all-namespaces -o=wide'
alias kgingallwojson='kubectl get ingress --all-namespaces --watch -o=json'
alias kgingwojsonall='kubectl get ingress --watch -o=json --all-namespaces'
alias kgingwallojson='kubectl get ingress --watch --all-namespaces -o=json'
alias kgingl='kubectl get ingress -l'
alias kdingl='kubectl describe ingress -l'
alias krmingl='kubectl delete ingress -l'
alias kgingoyamll='kubectl get ingress -o=yaml -l'
alias kgingowidel='kubectl get ingress -o=wide -l'
alias kgingojsonl='kubectl get ingress -o=json -l'
alias kgingwl='kubectl get ingress --watch -l'
alias kgingwoyamll='kubectl get ingress --watch -o=yaml -l'
alias kgingwowidel='kubectl get ingress --watch -o=wide -l'
alias kgingwojsonl='kubectl get ingress --watch -o=json -l'
alias kgingn='kubectl get ingress --namespace'
alias kdingn='kubectl describe ingress --namespace'
alias krmingn='kubectl delete ingress --namespace'
alias kgingoyamln='kubectl get ingress -o=yaml --namespace'
alias kgingowiden='kubectl get ingress -o=wide --namespace'
alias kgingojsonn='kubectl get ingress -o=json --namespace'
alias kgingwn='kubectl get ingress --watch --namespace'
alias kgingwoyamln='kubectl get ingress --watch -o=yaml --namespace'
alias kgingwowiden='kubectl get ingress --watch -o=wide --namespace'
alias kgingwojsonn='kubectl get ingress --watch -o=json --namespace'

# Configmap
alias kgcm='kubectl get configmap'
alias kdcm='kubectl describe configmap'
alias krmcm='kubectl delete configmap'
alias kgcmoyaml='kubectl get configmap -o=yaml'
alias kgcmowide='kubectl get configmap -o=wide'
alias kgcmojson='kubectl get configmap -o=json'
alias kgcmall='kubectl get configmap --all-namespaces'
alias kdcmall='kubectl describe configmap --all-namespaces'
alias krmcmall='kubectl delete configmap --all'
alias kgcmw='kubectl get configmap --watch'
alias kgcmoyamlall='kubectl get configmap -o=yaml --all-namespaces'
alias kgcmalloyaml='kubectl get configmap --all-namespaces -o=yaml'
alias kgcmwoyaml='kubectl get configmap --watch -o=yaml'
alias kgcmowideall='kubectl get configmap -o=wide --all-namespaces'
alias kgcmallowide='kubectl get configmap --all-namespaces -o=wide'
alias kgcmwowide='kubectl get configmap --watch -o=wide'
alias kgcmojsonall='kubectl get configmap -o=json --all-namespaces'
alias kgcmallojson='kubectl get configmap --all-namespaces -o=json'
alias kgcmwojson='kubectl get configmap --watch -o=json'
alias kgcmallw='kubectl get configmap --all-namespaces --watch'
alias kgcmwall='kubectl get configmap --watch --all-namespaces'
alias kgcmallwoyaml='kubectl get configmap --all-namespaces --watch -o=yaml'
alias kgcmwoyamlall='kubectl get configmap --watch -o=yaml --all-namespaces'
alias kgcmwalloyaml='kubectl get configmap --watch --all-namespaces -o=yaml'
alias kgcmallwowide='kubectl get configmap --all-namespaces --watch -o=wide'
alias kgcmwowideall='kubectl get configmap --watch -o=wide --all-namespaces'
alias kgcmwallowide='kubectl get configmap --watch --all-namespaces -o=wide'
alias kgcmallwojson='kubectl get configmap --all-namespaces --watch -o=json'
alias kgcmwojsonall='kubectl get configmap --watch -o=json --all-namespaces'
alias kgcmwallojson='kubectl get configmap --watch --all-namespaces -o=json'
alias kgcml='kubectl get configmap -l'
alias kdcml='kubectl describe configmap -l'
alias krmcml='kubectl delete configmap -l'
alias kgcmoyamll='kubectl get configmap -o=yaml -l'
alias kgcmowidel='kubectl get configmap -o=wide -l'
alias kgcmojsonl='kubectl get configmap -o=json -l'
alias kgcmwl='kubectl get configmap --watch -l'
alias kgcmwoyamll='kubectl get configmap --watch -o=yaml -l'
alias kgcmwowidel='kubectl get configmap --watch -o=wide -l'
alias kgcmwojsonl='kubectl get configmap --watch -o=json -l'
alias kgcmn='kubectl get configmap --namespace'
alias kdcmn='kubectl describe configmap --namespace'
alias krmcmn='kubectl delete configmap --namespace'
alias kgcmoyamln='kubectl get configmap -o=yaml --namespace'
alias kgcmowiden='kubectl get configmap -o=wide --namespace'
alias kgcmojsonn='kubectl get configmap -o=json --namespace'
alias kgcmwn='kubectl get configmap --watch --namespace'
alias kgcmwoyamln='kubectl get configmap --watch -o=yaml --namespace'
alias kgcmwowiden='kubectl get configmap --watch -o=wide --namespace'
alias kgcmwojsonn='kubectl get configmap --watch -o=json --namespace'

# Secret
alias kgsec='kubectl get secret'
alias kdsec='kubectl describe secret'
alias krmsec='kubectl delete secret'
alias kgsecoyaml='kubectl get secret -o=yaml'
alias kgsecowide='kubectl get secret -o=wide'
alias kgsecojson='kubectl get secret -o=json'
alias kgsecall='kubectl get secret --all-namespaces'
alias kdsecall='kubectl describe secret --all-namespaces'
alias krmsecall='kubectl delete secret --all'
alias kgsecw='kubectl get secret --watch'
alias kgsecoyamlall='kubectl get secret -o=yaml --all-namespaces'
alias kgsecalloyaml='kubectl get secret --all-namespaces -o=yaml'
alias kgsecwoyaml='kubectl get secret --watch -o=yaml'
alias kgsecowideall='kubectl get secret -o=wide --all-namespaces'
alias kgsecallowide='kubectl get secret --all-namespaces -o=wide'
alias kgsecwowide='kubectl get secret --watch -o=wide'
alias kgsecojsonall='kubectl get secret -o=json --all-namespaces'
alias kgsecallojson='kubectl get secret --all-namespaces -o=json'
alias kgsecwojson='kubectl get secret --watch -o=json'
alias kgsecallw='kubectl get secret --all-namespaces --watch'
alias kgsecwall='kubectl get secret --watch --all-namespaces'
alias kgsecallwoyaml='kubectl get secret --all-namespaces --watch -o=yaml'
alias kgsecwoyamlall='kubectl get secret --watch -o=yaml --all-namespaces'
alias kgsecwalloyaml='kubectl get secret --watch --all-namespaces -o=yaml'
alias kgsecallwowide='kubectl get secret --all-namespaces --watch -o=wide'
alias kgsecwowideall='kubectl get secret --watch -o=wide --all-namespaces'
alias kgsecwallowide='kubectl get secret --watch --all-namespaces -o=wide'
alias kgsecallwojson='kubectl get secret --all-namespaces --watch -o=json'
alias kgsecwojsonall='kubectl get secret --watch -o=json --all-namespaces'
alias kgsecwallojson='kubectl get secret --watch --all-namespaces -o=json'
alias kgsecl='kubectl get secret -l'
alias kdsecl='kubectl describe secret -l'
alias krmsecl='kubectl delete secret -l'
alias kgsecoyamll='kubectl get secret -o=yaml -l'
alias kgsecowidel='kubectl get secret -o=wide -l'
alias kgsecojsonl='kubectl get secret -o=json -l'
alias kgsecwl='kubectl get secret --watch -l'
alias kgsecwoyamll='kubectl get secret --watch -o=yaml -l'
alias kgsecwowidel='kubectl get secret --watch -o=wide -l'
alias kgsecwojsonl='kubectl get secret --watch -o=json -l'
alias kgsecn='kubectl get secret --namespace'
alias kdsecn='kubectl describe secret --namespace'
alias krmsecn='kubectl delete secret --namespace'
alias kgsecoyamln='kubectl get secret -o=yaml --namespace'
alias kgsecowiden='kubectl get secret -o=wide --namespace'
alias kgsecojsonn='kubectl get secret -o=json --namespace'
alias kgsecwn='kubectl get secret --watch --namespace'
alias kgsecwoyamln='kubectl get secret --watch -o=yaml --namespace'
alias kgsecwowiden='kubectl get secret --watch -o=wide --namespace'
alias kgsecwojsonn='kubectl get secret --watch -o=json --namespace'

# Nodes
alias kgno='kubectl get nodes'
alias kdno='kubectl describe nodes'
alias kgnooyaml='kubectl get nodes -o=yaml'
alias kgnoowide='kubectl get nodes -o=wide'
alias kgnoojson='kubectl get nodes -o=json'
alias kgnow='kubectl get nodes --watch'
alias kgnowoyaml='kubectl get nodes --watch -o=yaml'
alias kgnowowide='kubectl get nodes --watch -o=wide'
alias kgnowojson='kubectl get nodes --watch -o=json'
alias kgnol='kubectl get nodes -l'
alias kdnol='kubectl describe nodes -l'
alias kgnooyamll='kubectl get nodes -o=yaml -l'
alias kgnoowidel='kubectl get nodes -o=wide -l'
alias kgnoojsonl='kubectl get nodes -o=json -l'
alias kgnowl='kubectl get nodes --watch -l'
alias kgnowoyamll='kubectl get nodes --watch -o=yaml -l'
alias kgnowowidel='kubectl get nodes --watch -o=wide -l'
alias kgnowojsonl='kubectl get nodes --watch -o=json -l'

# Cluster Role
alias kgcro='kubectl get clusterroles'
alias kgcrb='kubectl get clusterrolebinding'
alias kdcro='kubectl describe clusterrole'
alias kdcrb='kubectl describe clusterrolebinding'


# Utilities
alias cl='clear'
alias ls='ls -ltr'
alias setns='kubectl config set-context --current'
alias kgcon='kubectl config get-contexts'
alias kusecon='kubectl config use-context'
alias kgev="kubectl get events --sort-by='.lastTimestamp'"

export do='--dry-run=client -o yaml'
export fg='--force --grace-period=0'

